"filename", "language", "Python", "comment", "blank", "total"
"/Users/dasuncharuka/Desktop/new/math-llm-system/orchestration/__init__.py", "Python", 0, 0, 1, 1
"/Users/dasuncharuka/Desktop/new/math-llm-system/orchestration/agents/__init__.py", "Python", 0, 0, 1, 1
"/Users/dasuncharuka/Desktop/new/math-llm-system/orchestration/agents/agent_info.py", "Python", 267, 4, 22, 293
"/Users/dasuncharuka/Desktop/new/math-llm-system/orchestration/agents/base_agent.py", "Python", 435, 49, 103, 587
"/Users/dasuncharuka/Desktop/new/math-llm-system/orchestration/agents/capability_advertisement.py", "Python", 216, 21, 60, 297
"/Users/dasuncharuka/Desktop/new/math-llm-system/orchestration/agents/communication.py", "Python", 319, 25, 68, 412
"/Users/dasuncharuka/Desktop/new/math-llm-system/orchestration/agents/fault_tolerance.py", "Python", 307, 58, 91, 456
"/Users/dasuncharuka/Desktop/new/math-llm-system/orchestration/agents/load_balancer.py", "Python", 219, 46, 77, 342
"/Users/dasuncharuka/Desktop/new/math-llm-system/orchestration/agents/multimodal_config.py", "Python", 106, 3, 18, 127
"/Users/dasuncharuka/Desktop/new/math-llm-system/orchestration/agents/registry.py", "Python", 212, 19, 50, 281
"/Users/dasuncharuka/Desktop/new/math-llm-system/orchestration/manager/__init__.py", "Python", 0, 0, 1, 1
"/Users/dasuncharuka/Desktop/new/math-llm-system/orchestration/manager/orchestration_manager.py", "Python", 404, 79, 121, 604
"/Users/dasuncharuka/Desktop/new/math-llm-system/orchestration/message_bus/__init__.py", "Python", 0, 0, 1, 1
"/Users/dasuncharuka/Desktop/new/math-llm-system/orchestration/message_bus/message_formats.py", "Python", 197, 5, 36, 238
"/Users/dasuncharuka/Desktop/new/math-llm-system/orchestration/message_bus/message_handler.py", "Python", 204, 21, 52, 277
"/Users/dasuncharuka/Desktop/new/math-llm-system/orchestration/message_bus/rabbitmq_wrapper.py", "Python", 267, 29, 58, 354
"/Users/dasuncharuka/Desktop/new/math-llm-system/orchestration/monitoring/__init__.py", "Python", 0, 0, 1, 1
"/Users/dasuncharuka/Desktop/new/math-llm-system/orchestration/monitoring/logger.py", "Python", 106, 15, 34, 155
"/Users/dasuncharuka/Desktop/new/math-llm-system/orchestration/monitoring/metrics.py", "Python", 204, 14, 51, 269
"/Users/dasuncharuka/Desktop/new/math-llm-system/orchestration/monitoring/tracing.py", "Python", 153, 4, 32, 189
"/Users/dasuncharuka/Desktop/new/math-llm-system/orchestration/tests/__init__.py", "Python", 0, 0, 1, 1
"/Users/dasuncharuka/Desktop/new/math-llm-system/orchestration/workflow/__init__.py", "Python", 0, 0, 1, 1
"/Users/dasuncharuka/Desktop/new/math-llm-system/orchestration/workflow/end_to_end_workflows.py", "Python", 259, 37, 73, 369
"/Users/dasuncharuka/Desktop/new/math-llm-system/orchestration/workflow/enhanced_workflows.py", "Python", 957, 111, 232, 1300
"/Users/dasuncharuka/Desktop/new/math-llm-system/orchestration/workflow/error_handler.py", "Python", 233, 21, 54, 308
"/Users/dasuncharuka/Desktop/new/math-llm-system/orchestration/workflow/error_recovery.py", "Python", 1126, 172, 274, 1572
"/Users/dasuncharuka/Desktop/new/math-llm-system/orchestration/workflow/integrated_response_workflow.py", "Python", 344, 35, 87, 466
"/Users/dasuncharuka/Desktop/new/math-llm-system/orchestration/workflow/multimodal_workflows.py", "Python", 383, 22, 60, 465
"/Users/dasuncharuka/Desktop/new/math-llm-system/orchestration/workflow/standard_workflows.py", "Python", 265, 7, 26, 298
"/Users/dasuncharuka/Desktop/new/math-llm-system/orchestration/workflow/visualization_handler.py", "Python", 352, 64, 94, 510
"/Users/dasuncharuka/Desktop/new/math-llm-system/orchestration/workflow/visualization_workflows.py", "Python", 143, 11, 14, 168
"/Users/dasuncharuka/Desktop/new/math-llm-system/orchestration/workflow/workflow_definition.py", "Python", 185, 7, 37, 229
"/Users/dasuncharuka/Desktop/new/math-llm-system/orchestration/workflow/workflow_engine.py", "Python", 958, 142, 272, 1372
"/Users/dasuncharuka/Desktop/new/math-llm-system/orchestration/workflow/workflow_registry.py", "Python", 353, 28, 64, 445
"Total", "-", 9174, 1049, 2167, 12390